###################################################################################################################
#      #   #   #                              #                     #                                             #
#   #  #   #   #      ##################      #                                                                   #
#   #  #   #   #      ##################      #                     ###############################################
#   #  #   #   #      ##################                            #                                             #
#   # ##   #   #      #####################  ##############         ########################### ###################
#####          #      ##################         #                  #                                             #
#      #       #      ##################         #                  ########################################      #
########       #           #############         #                  #                                             #
#              #      #    #                     #                  ###################### ########################
#              #      #    #   ###################                  #                                             #
#####  #########      #    #      #      #                                                                        #
#                     #    #      #      #################  ########################################## ############
#                     #    #      #      #          #                                     #                       #
#######################    #      #      #          #                                     #                       #
#                     #    #             #                                                #                       #
#                     #    ###############          #                                     #                       #
#                     #    #             #          #          #                          #                       #
#### ##################    #             #          #          #                          #                       #
#                          #             #          #          #                          #####################   #
#                          #             #          #          #                          #####################   #
############################             #######################                          #####################   #
#                          #             #                     #                          #                       #
#                          #             #                     #                          #####################   #
#                                                                                         #                       #
#                          #             #                     #                          #                       #
#                          #             #                     #                          #                       #
###################################################################################################################